...................
.###############.#.
.#...............#.
.#...............#.
.#################.
...................
\robot 0 0
\robot 1 0
\robot 2 0